X-11
(60, Jack, 412-111-1111)
(61, Jack, 412-111-1111)
(62, Jack, 412-111-1111)
(63, Jack, 412-111-1111)
(64, Jack, 412-111-1111)
(65, Jack, 412-111-1111)
(66, Jack, 412-111-1111)
(67, Jack, 412-111-1111)
(68, Jack, 412-111-1111)
(69, Jack, 412-111-1111)
