X-13
(70, Jack, 412-111-1111)
(71, Jack, 412-111-1111)
(72, Jack, 412-111-1111)
(73, Jack, 412-111-1111)
(74, Jack, 412-111-1111)
(75, Jack, 412-111-1111)
(76, Jack, 412-111-1111)
(77, Jack, 412-111-1111)
(78, Jack, 412-111-1111)
(79, Jack, 412-111-1111)
