X-15
(80, Jack, 412-111-1111)
(81, Jack, 412-111-1111)
(82, Jack, 412-111-1111)
(83, Jack, 412-111-1111)
(84, Jack, 412-111-1111)
(85, Jack, 412-111-1111)
(86, Jack, 412-111-1111)
(87, Jack, 412-111-1111)
(88, Jack, 412-111-1111)
(89, Jack, 412-111-1111)
