X-17
(90, Jack, 412-111-1111)
(91, Jack, 412-111-1111)
(92, Jack, 412-111-1111)
(93, Jack, 412-111-1111)
(94, Jack, 412-111-1111)
(95, Jack, 412-111-1111)
(96, Jack, 412-111-1111)
(97, Jack, 412-111-1111)
(98, Jack, 412-111-1111)
(99, Jack, 412-111-1111)
