X-19
(100, Jack, 412-111-1111)
(101, Jack, 412-111-1111)
(102, Jack, 412-111-1111)
(103, Jack, 412-111-1111)
(104, Jack, 412-111-1111)
(105, Jack, 412-111-1111)
(106, Jack, 412-111-1111)
(107, Jack, 412-111-1111)
(108, Jack, 412-111-1111)
(109, Jack, 412-111-1111)
