X-2
(0, Jack, 412-111-1111)
(1, Jack, 412-111-1111)
(2, Jack, 412-111-1111)
(3, Jack, 412-111-1111)
(4, Jack, 412-111-1111)
(5, Jack, 412-111-1111)
(6, Jack, 412-111-1111)
(7, Jack, 412-111-1111)
(8, Jack, 412-111-1111)
(9, Jack, 412-111-1111)
