X-21
(110, Jack, 412-111-1111)
(111, Jack, 412-111-1111)
(112, Jack, 412-111-1111)
(113, Jack, 412-111-1111)
(114, Jack, 412-111-1111)
(115, Jack, 412-111-1111)
(116, Jack, 412-111-1111)
(117, Jack, 412-111-1111)
(118, Jack, 412-111-1111)
(119, Jack, 412-111-1111)
