X-23
(120, Jack, 412-111-1111)
(121, Jack, 412-111-1111)
(122, Jack, 412-111-1111)
(123, Jack, 412-111-1111)
(124, Jack, 412-111-1111)
(125, Jack, 412-111-1111)
(126, Jack, 412-111-1111)
(127, Jack, 412-111-1111)
(128, Jack, 412-111-1111)
(129, Jack, 412-111-1111)
