X-7
(40, Jack, 412-111-1111)
(41, Jack, 412-111-1111)
(42, Jack, 412-111-1111)
(43, Jack, 412-111-1111)
(44, Jack, 412-111-1111)
(45, Jack, 412-111-1111)
(46, Jack, 412-111-1111)
(47, Jack, 412-111-1111)
(48, Jack, 412-111-1111)
(49, Jack, 412-111-1111)
