X-9
(50, Jack, 412-111-1111)
(51, Jack, 412-111-1111)
(52, Jack, 412-111-1111)
(53, Jack, 412-111-1111)
(54, Jack, 412-111-1111)
(55, Jack, 412-111-1111)
(56, Jack, 412-111-1111)
(57, Jack, 412-111-1111)
(58, Jack, 412-111-1111)
(59, Jack, 412-111-1111)
