X-3
(10, Jack, 412-111-1111)
(11, Jack, 412-111-1111)
(12, Jack, 412-111-1111)
(13, Jack, 412-111-1111)
(14, Jack, 412-111-1111)
(15, Jack, 412-111-1111)
(16, Jack, 412-111-1111)
(17, Jack, 412-111-1111)
(18, Jack, 412-111-1111)
(19, Jack, 412-111-1111)
