X-4
(20, Jack, 412-111-1111)
(21, Jack, 412-111-1111)
(22, Jack, 412-111-1111)
(23, Jack, 412-111-1111)
(24, Jack, 412-111-1111)
(25, Jack, 412-111-1111)
(26, Jack, 412-111-1111)
(27, Jack, 412-111-1111)
(28, Jack, 412-111-1111)
(29, Jack, 412-111-1111)
