X-5
(30, Jack, 412-111-1111)
(31, Jack, 412-111-1111)
(32, Jack, 412-111-1111)
(33, Jack, 412-111-1111)
(34, Jack, 412-111-1111)
(35, Jack, 412-111-1111)
(36, Jack, 412-111-1111)
(37, Jack, 412-111-1111)
(38, Jack, 412-111-1111)
(39, Jack, 412-111-1111)
